2001A4030807
2001A4042509
2001A4051208
2001A4061609
2001A4071409
2001A4100608
2001A4110608