2017C0a00101
2017C0a00201
2017C0a00405
2017C0a00503
2017C0a00704