2017C2a00210
2017C2a00306
2017C2a00506
2017C2a00606
2017C2a00805