2017G0a00104
2017G0a00109
2017G0a00203
2017G0a00207
2017G0a00410
2017G0a00607
2017G0a00608
2017G0a00703
2017G0a00710
2017G0a00808
2017G0a00909
2017G0a00a08
2017G0a00b03
2017G0a00c07
2017G0a00d07
2017G0a00d08
2017G0a00e06
2017G0a00e07
2017G0a00e08
2017G0a01008
2017G0a01708
2017G0a01a09
2017G0a02407
2017G0a02505