2017G0a00410
2017G0a00710
2017G0a00808
2017G0a00909
2017G0a00d08
2017G0a00e08
2017G0a01008
2017G0a01708
2017G0a01a09
2017G0a02407
2017G0a02505