2017H1043008
2017H1121004
2017H1121005
2017H1121007
2017H1121008
2017H1a00107
2017H1a00108