2017J0032501
2017J0032504
2017J0032506
2017J0032507
2017J0032508
2017J0032509