2006G0042301
2006G0a00103
2006G0a00105
2006G0a00107
2006G0a00108