2015A8a00202
2015A8a00305
2015A8a00604
2015A8a00704
2015A8a00802
2015A8a00903
2015A8a00a05
2015A8a00b04
2015A8a00c02
2015A8a00d04
2015A8a00e04
2015A8a00e06
2015A8a00f06
2015A8a01809
2015A8a01f04
2015A8a02105
2015A8a02d04
2015A8a02e04
2015A8a03602
2015A8a03a01
2015A8a03b01