2015B2a00201
2015B2a00204
2015B2a00905
2015B2a00906
2015B2a00c05
2015B2a01504
2015B2a01c05