2015B4a00307
2015B4a00405
2015B4a00508
2015B4a00604
2015B4a00702