2015B6a00104
2015B6a00108
2015B6a00207
2015B6a00309
2015B6a00509