2015C2a00401
2015C2a00702
2015C2a00a06
2015C2a00b06
2015C2a00b07
2015C2a00c06
2015C2a01107
2015C2a01202
2015C2a01302
2015C2a01a01