2015C7a00904
2015C7a00906
2015C7a00907
2015C7a00908
2015C7a00909