2015E0a00106
2015E0a00209
2015E0a00310
2015E0a00408
2015E0a00505