2015G0a00210
2015G0a00309
2015G0a00509
2015G0a00608
2015G0a00708
2015G0a00709
2015G0a00b10
2015G0a00c09
2015G0a00f06
2015G0a01008
2015G0a01105
2015G0a01206
2015G0a01207
2015G0a01210
2015G0a01308
2015G0a01310
2015G0a01609
2015G0a01709
2015G0a01811
2015G0a01910
2015G0a01a05
2015G0a01a06
2015G0a01a07
2015G0a01a08
2015G0a01a10
2015G0a01e11
2015G0a02509
2015G0a02705
2015G0a02810
2015G0a02907
2015G0a03401