2019B6a00107
2019B6a00407
2019B6a00807
2019B6a00a07
2019B6a02008