2019C8100604
2019C8a00106
2019C8a00207
2019C8a00304
2019C8a00701
2019C8a00e05
2019C8a01107