2019J0033002
2019J0033005
2019J0033006
2019J0033007
2019J0033008
2019J0033009