2003A6050404
2003A6060605
2003A6060705
2003A6061902
2003A6070305
2003A6082002
2003A6082505
2003A6091305
2003A6100301
2003A6100407
2003A6101104
2003A6101305
2003A6102102
2003A6110108