2003A8051805
2003A8080501
2003A8081704
2003A8090203
2003A8090705
2003A8092002
2003A8110104
2003A8a00103