2016C0a00403
2016C0a00502
2016C0a00602
2016C0a00703
2016C0a00803
2016C0a00901