2016C2a00505
2016C2a00606
2016C2a00706
2016C2a00807
2016C2a00907
2016C2a00a06
2016C2a00b06
2016C2a00c06
2016C2a01201
2016C2a01307
2016C2a01408