2016C7a00506
2016C7a00604
2016C7a00707
2016C7a00708
2016C7a00709