2016C7a00306
2016C7a00506
2016C7a00604
2016C7a00704
2016C7a00705
2016C7a00707
2016C7a00708
2016C7a00709