2016C7a00302
2016C7a00306
2016C7a00506
2016C7a00604
2016C7a00703
2016C7a00704
2016C7a00705
2016C7a00706
2016C7a00707
2016C7a00708
2016C7a00709
2016C7a00a04