2016G0a00109
2016G0a00307
2016G0a00309
2016G0a00409
2016G0a00808
2016G0a00907
2016G0a00908
2016G0a00a03
2016G0a00a07
2016G0a00b08
2016G0a00c04
2016G0a00c08
2016G0a00d07
2016G0a00d08
2016G0a00e07
2016G0a00e09
2016G0a00f08
2016G0a01003
2016G0a01108
2016G0a01210
2016G0a01310
2016G0a01407
2016G0a01a01
2016G0a01a09
2016G0a01b03
2016G0a01d02
2016G0a01e07
2016G0a02702
2016G0a02808
2016G0a02809
2016G0a02f06