2016H1121104
2016H1121105
2016H1121107
2016H1121108
2016H1121110