2007C7a00103
2007C7a00202
2007C7a00203
2007C7a00206
2007C7a00207