2021J0032702
2021J0032705
2021J0032706
2021J0032707
2021J0032708
2021J0032709