2012A6060205
2012A6a00106
2012A6a00201
2012A6a00202
2012A6a00302
2012A6a00405
2012A6a00602
2012A6a00604
2012A6a00701
2012A6a00a04
2012A6a00b02
2012A6a00d04
2012A6a01101
2012A6a01401
2012A6a01501
2012A6a01601
2012A6a01704
2012A6a01b03
2012A6a02b04