2012A6060205
2012A6a00106
2012A6a00201
2012A6a00202
2012A6a00405
2012A6a00604
2012A6a00701
2012A6a00a04
2012A6a01b03