2012A8a00201
2012A8a00601
2012A8a00701
2012A8a00803
2012A8a00806
2012A8a00906
2012A8a00a03
2012A8a00b01
2012A8a00c01
2012A8a01201
2012A8a01c01
2012A8a01e02
2012A8a02803