2012B2a00108
2012B2a00405
2012B2a00608
2012B2a00a04
2012B2a00b02
2012B2a01201
2012B2a01301
2012B2a01401
2012B2a01801