2012C7a00507
2012C7a00803
2012C7a00804
2012C7a00805
2012C7a00806
2012C7a00807
2012C7a00809