2012G0a00108
2012G0a00307
2012G0a00507
2012G0a00603
2012G0a00608
2012G0a00708
2012G0a00808
2012G0a00907
2012G0a00a09
2012G0a00b10
2012G0a00c07
2012G0a00c08
2012G0a00e09
2012G0a00f08
2012G0a00f09
2012G0a01704
2012G0a01705
2012G0a01707