2012M0a00109
2012M0a00210
2012M0a00307
2012M0a00410
2012M0a00510
2012M0a00610