2005A6050102
2005A6050103
2005A6060304
2005A6060405
2005A6060604
2005A6061503
2005A6062304
2005A6070805
2005A6072305
2005A6081405
2005A6081604
2005A6092401
2005A6100103
2005A6101503