2009A4a00108
2009A4a00510
2009A4a00a10
2009A4a01109
2009A4a01204
2009A4a01305