2009A6060605
2009A6a00803
2009A6a00906
2009A6a00a03
2009A6a00b04
2009A6a01101
2009A6a01201
2009A6a01301
2009A6a01401
2009A6a01506
2009A6a01604
2009A6a01704
2009A6a01a01
2009A6a01b01