2009A8a00106
2009A8a00605
2009A8a00704
2009A8a00804
2009A8a00904