2009B2a00104
2009B2a00201
2009B2a00301
2009B2a00401
2009B2a00502
2009B2a00601