2009G0a00704
2009G0a00705
2009G0a00708
2009G0a00709
2009G0a00809
2009G0a00910
2009G0a00a10