2018B6a00307
2018B6a00308
2018B6a00404
2018B6a00508
2018B6a00e08
2018B6a00f07
2018B6a01008
2018B6a01009
2018B6a02008
2018B6a02305