2018J0033101
2018J0033104
2018J0033106
2018J0033107
2018J0033108
2018J0033109