2002A4022300
2002A4041800
2002A4050300
2002A4052700
2002A4062200