2002A6060805
2002A6071902
2002A6081003
2002A6090704
2002A6091105
2002A6091204
2002A6092802
2002A6101808