2014A4a00109
2014A4a00110
2014A4a00308
2014A4a00412
2014A4a00608
2014A4a00710
2014A4a00712
2014A4a00808
2014A4a00910
2014A4a00a08
2014A4a00b08
2014A4a00c12
2014A4a00d05
2014A4a00d09
2014A4a00e05
2014A4a01008
2014A4a01308
2014A4a01412
2014A4a01511
2014A4a01c03
2014A4a01e08
2014A4a01f11
2014A4a02711
2014A4a02810
2014A4a04608
2014A4a04704