2014A8a00105
2014A8a00401
2014A8a00504
2014A8a00604
2014A8a00705
2014A8a00c03
2014A8a00c05
2014A8a01f03