2014B2a00105
2014B2a00501
2014B2a00605
2014B2a00704
2014B2a00c04
2014B2a00e05
2014B2a00f04
2014B2a00f07
2014B2a01804
2014B2a01a01
2014B2a01d01