2014B4a00610
2014B4a00705
2014B4a00801
2014B4a00902
2014B4a00a02