2014B6a00107
2014B6a00202
2014B6a00208
2014B6a00301
2014B6a00406
2014B6a00501
2014B6a00605