2014C2a00101
2014C2a00201
2014C2a00301
2014C2a00401
2014C2a00701
2014C2a00e01