2014C2a00101
2014C2a00201
2014C2a00301
2014C2a00401
2014C2a00701
2014C2a00d01
2014C2a00e01
2014C2a00f06
2014C2a01004
2014C2a01102