2014C7a00505
2014C7a00807
2014C7a00808
2014C7a00809
2014C7a00d05