2014C7a00304
2014C7a00307
2014C7a00505
2014C7a00802
2014C7a00803
2014C7a00806
2014C7a00807
2014C7a00808
2014C7a00809
2014C7a00d05