2014G0a00408
2014G0a00509
2014G0a01208
2014G0a01c05
2014G0a01c07