2014G0a00408
2014G0a00509
2014G0a00c02
2014G0a01010
2014G0a01205
2014G0a01208
2014G0a01410
2014G0a01510
2014G0a01608
2014G0a01c05
2014G0a01c07
2014G0a01c08
2014G0a01c10
2014G0a01f05
2014G0a01f09
2014G0a02007
2014G0a02108
2014G0a02207
2014G0a02304
2014G0a02405
2014G0a02504
2014G0a02606