2013B2a00704
2013B2a00804
2013B2a00a03
2013B2a00b04
2013B2a00b07
2013B2a00d01
2013B2a01201
2013B2a01304
2013B2a01405
2013B2a02101
2013B2a02201