2013C7a00307
2013C7a00804
2013C7a00806
2013C7a00808
2013C7a00809