2013G0a00108
2013G0a00207
2013G0a00307
2013G0a00308
2013G0a00409
2013G0a00707
2013G0a00709
2013G0a00808
2013G0a00811
2013G0a00907
2013G0a00908
2013G0a00a10
2013G0a00b07
2013G0a00b08
2013G0a00c08
2013G0a00d08
2013G0a01108
2013G0a01601
2013G0a01604
2013G0a01605
2013G0a01607
2013G0a01608
2013G0a01807
2013G0a01908
2013G0a02007
2013G0a02108