2008A4a00209
2008A4a00611
2008A4a00708
2008A4a00801
2008A4a00808
2008A4a00809
2008A4a02403
2008A4a02506
2008A4a02608