2008A6060705
2008A6a00402
2008A6a00503
2008A6a00601
2008A6a00703
2008A6a00802
2008A6a00902
2008A6a00b05
2008A6a00c04
2008A6a00d02
2008A6a00e02