2008A8a00402
2008A8a00506
2008A8a00603
2008A8a00703
2008A8a00704
2008A8a00803
2008A8a00905
2008A8a00a03
2008A8a00b03
2008A8a01004
2008A8a01105