2011A4a00410
2011A4a00411
2011A4a00801
2011A4a00910
2011A4a00a06
2011A4a00b08
2011A4a01012
2011A4a01111
2011A4a01201
2011A4a01301