2011A6060405
2011A6a00101
2011A6a00301
2011A6a00401
2011A6a00402
2011A6a00501
2011A6a00601
2011A6a00703
2011A6a00803
2011A6a00804
2011A6a00805
2011A6a00901
2011A6a00a01
2011A6a00b01
2011A6a00c01
2011A6a00d01
2011A6a00e01
2011A6a01a01
2011A6a01b01
2011A6a01c03