2011A8a00202
2011A8a00706
2011A8a00801
2011A8a00a01
2011A8a00b01
2011A8a01001
2011A8a01002
2011A8a01201
2011A8a01301