2011A8a00102
2011A8a00107
2011A8a00201
2011A8a00202
2011A8a00206
2011A8a00302
2011A8a00402
2011A8a00502
2011A8a00706
2011A8a00801
2011A8a00901
2011A8a00a01
2011A8a00b01
2011A8a00c01
2011A8a00d01
2011A8a00e01
2011A8a00f01
2011A8a01001
2011A8a01002
2011A8a01107
2011A8a01201
2011A8a01301
2011A8a01e03