2011B2a00101
2011B2a00401
2011B2a00701
2011B2a00804
2011B2a00905