2011C7a00201
2011C7a00202
2011C7a00203
2011C7a00205
2011C7a00206
2011C7a00301