2011G0a00101
2011G0a00209
2011G0a00309
2011G0a00408
2011G0a00709
2011G0a00808
2011G0a00907
2011G0a00a10
2011G0a00f04
2011G0a00f05
2011G0a00f07
2011G0a01510