2010A4a00107
2010A4a00209
2010A4a00210
2010A4a00309
2010A4a00409
2010A4a00501
2010A4a00601
2010A4a00607
2010A4a00e10
2010A4a00f09
2010A4a01010