2010A6a00101
2010A6a00201
2010A6a00301
2010A6a00401
2010A6a00602
2010A6a00703
2010A6a00a02
2010A6a00d01
2010A6a00e10
2010A6a00f01
2010A6a01102
2010A6a01701
2010A6a01c01