2010A8a00105
2010A8a00106
2010A8a00107
2010A8a00108
2010A8a00201
2010A8a00206
2010A8a00306
2010A8a00504
2010A8a00a07
2010A8a01204
2010A8a01303
2010A8a01405
2010A8a01706