2010C7a00106
2010C7a00203
2010C7a00205
2010C7a00207
2010C7a00208