2010G0a00107
2010G0a00108
2010G0a00208
2010G0a00303
2010G0a00308
2010G0a00407
2010G0a00509
2010G0a00608
2010G0a00708
2010G0a00e04
2010G0a00e05
2010G0a00e07
2010G0a00e08
2010G0a01101
2010G0a01201
2010G0a01307
2010G0a01308
2010G0a01409
2010G0a01504
2010G0a01610
2010G0a01708
2010G0a01808
2010G0a01904
2010G0a01a07